dr.josephsummers		pwddr.josephsummers
sarahgolden		pwdsarahgolden
adamjones		pwdadamjones
wesleymejiadds		pwdwesleymejiadds
christinarush		pwdchristinarush
granthenson		pwdgranthenson
chaseashley		pwdchaseashley
barbararusso		pwdbarbararusso
ginapope		pwdginapope
jasonfriedman		pwdjasonfriedman
hannahcarlson		pwdhannahcarlson
travispierce		pwdtravispierce
marklewis		pwdmarklewis
bonniejohnson		pwdbonniejohnson
edwardserrano		pwdedwardserrano
angelarocha		pwdangelarocha
nicholemyers		pwdnicholemyers
stevenmiller		pwdstevenmiller
christinajohnson		pwdchristinajohnson
bradleydavis		pwdbradleydavis
jessicaramirez		pwdjessicaramirez
tinaadams		pwdtinaadams
tammycoleman		pwdtammycoleman
douglascarter		pwddouglascarter
matthewherring		pwdmatthewherring
robertojacobs		pwdrobertojacobs
patriciakennedy		pwdpatriciakennedy
heidihernandez		pwdheidihernandez
kennethcarpenter		pwdkennethcarpenter
robertcunningham		pwdrobertcunningham
crystalgeorge		pwdcrystalgeorge
kevinmonroe		pwdkevinmonroe
scottcase		pwdscottcase
missveronicarodriguez		pwdmissveronicarodriguez
victorialong		pwdvictorialong
shannonschultz		pwdshannonschultz
deborahyoung		pwddeborahyoung
christylarsen		pwdchristylarsen
sarahchang		pwdsarahchang
brandonlopez		pwdbrandonlopez
jessicaweiss		pwdjessicaweiss
mr.stevenbarber		pwdmr.stevenbarber
lisagomez		pwdlisagomez
sarahlambert		pwdsarahlambert
robertyu		pwdrobertyu
paulmendoza		pwdpaulmendoza
lancegentry		pwdlancegentry
rebeccapineda		pwdrebeccapineda
lisareid		pwdlisareid
mrs.nicolepotterdvm		pwdmrs.nicolepotterdvm
